44411111111111111111
44411111111111111111
44112222222222222222
44312111111111111111
44112111111111111111
44112111111311111111
41112222221111111111
41112111111111331111
41112111111113331111
11132111110000444111
11112111000000441111
11132111000044441111
11112111000031111111
11112111111111111111
11112111111111111111
