11111111111111111000
11111111111111111000
11111111111111111111
11111111111111111111
11111111111111111111
11111100000111111111
11111100001111111111
11111111111111111111
11111111111111111111
11111111111111111111
11111111111111111111
11111111111111111111
11111111111111111111
11111111000001111111
11111111100001111111
